##Post Tempus
WSL = "countries/Wastelands.txt"
SPN = "countries/Spain.txt"
PRT = "countries/Portugal.txt"
SFC = "countries/SpanishFrance.txt"
BSQ = "countries/BasqueCountry.txt"
CTL = "countries/Catalonia.txt"
GAL = "countries/Galicia.txt"
AQU = "countries/Aquataine.txt"
SWI = "countries/Switzerland.txt"
BRI = "countries/Brittany.txt"
COR = "countries/ThirdFrenchEmpire.txt"
NOR = "countries/Normandy.txt"
AND = "countries/Andorra.txt"
BCD = "countries/Braganca.txt"
IND = "countries/IdanhaaNova.txt"
VCD = "countries/VianadoCastelo.txt"
ELD = "countries/Elvas.txt"
BRD = "countries/Barrancos.txt"
MCO = "countries/Monaco.txt"
FCN = "countries/Nimes.txt"
HAS = "countries/HauteSavoie.txt"
FTC = "countries/Frejus.txt"
ORN = "countries/OrdreNouveau.txt"
TCN = "countries/Nice.txt"
SAR = "countries/Sardinia.txt"
FRA = "countries/France.txt"
MSF = "countries/MarxistFrance.txt"
FEA = "countries/AnarchistFrance.txt"
BHP = "countries/BlackHorde.txt"
TNO = "countries/Noocracy.txt"
SSP = "countries/Provence.txt"
FNR = "countries/FrenchNationalRepublic.txt"
KOF = "countries/KingdomofFrance.txt"
DNA = "countries/DuchyofNewAnjou.txt"
DNP = "countries/DuchyofNewParis.txt"
OCR = "countries/Occitania.txt"
IRL = "countries/ItalianRevivalLeague.txt"
PFS = "countries/Padania.txt"
DRP = "countries/Piedmont.txt"